101 7 2 3 4
102 3 3 2 4
103 4 6 1 3
104 5 3 3 5
105 4 3 6 4
106 1 3 8 3
107 4 5 2 1
108 3 4 2 5
109 1 5 5 2
110 3 2 3 4