0 7 2 3 4
1 3 3 2 4
2 4 6 1 3
3 5 3 3 5
4 4 3 6 4
5 1 3 8 3
6 4 5 2 1
7 3 4 2 5
8 1 5 5 2
9 3 2 3 4